111111111
1S00S0001
100CC0001
10S000001
1P0C00001
10000E001
111111111